//
0,0,0,0,0,0,0,0,0,0
0,0,1,1,1,1,1,1,1,0
0,0,1,0,6,4,4,4,1,0
0,0,1,0,0,0,1,1,1,1
0,1,1,1,3,0,0,0,0,1
0,1,0,0,0,1,3,1,0,1
0,1,0,3,0,1,0,0,0,1
0,1,0,0,0,1,1,1,1,1
0,1,1,1,1,1,0,0,0,0
0,0,0,0,0,0,0,0,0,0
//
1,1,1,1,1,1,1,1,1,1
1,1,1,1,1,1,1,1,1,1
1,1,6,0,0,0,1,1,1,1
1,1,0,3,1,3,1,1,1,1
1,1,0,3,0,0,1,1,1,1
1,1,0,1,0,0,1,1,1,1
1,1,0,3,4,4,0,1,1,1
1,1,1,1,4,4,0,1,1,1
1,1,1,1,1,1,1,1,1,1
1,1,1,1,1,1,1,1,1,1
//
1,1,1,1,1,1,1,1,1,1
1,1,1,1,1,1,1,1,1,1
1,1,0,0,1,0,0,0,1,1
1,1,0,3,4,4,3,0,1,1
1,1,6,3,4,7,0,1,1,1
1,1,0,3,4,4,3,0,1,1
1,1,0,0,1,0,0,0,1,1
1,1,1,1,1,1,1,1,1,1
1,1,1,1,1,1,1,1,1,1
1,1,1,1,1,1,1,1,1,1
//
0,0,0,0,0,0,0,0,0,0,0,0,0,0,0
0,0,0,0,0,0,0,0,0,0,0,0,0,0,0
1,0,0,0,0,0,0,0,0,0,0,0,0,0,0
1,0,0,0,0,0,0,0,0,0,0,0,0,0,0
1,0,0,0,0,0,0,0,0,0,0,0,0,0,0
1,0,0,0,0,0,0,0,0,0,0,0,0,0,0
1,0,0,0,0,0,0,0,0,0,0,0,0,0,0
0,0,0,0,0,0,0,0,0,0,0,0,0,0,0
0,0,0,0,0,0,0,0,0,0,0,0,0,0,0
0,0,0,0,0,0,0,0,0,0,0,0,0,0,0
0,0,0,0,0,0,0,0,0,0,0,0,0,0,0
0,0,0,4,3,0,6,0,0,0,0,0,0,0,0
0,0,0,0,0,0,3,0,0,0,0,0,0,0,0
0,0,0,0,0,0,4,0,0,0,0,0,0,0,0
0,0,0,0,0,0,0,0,0,0,0,0,0,0,0
//
0,0,0
4,3,6
